10 10 12

CCHCNHCCHN
NNCCCHHCCC
DNCCNNHHHC
CHHHCCCCCC
CCCCCNHHHH
PCHCCCNNNN
NNNNNHCCCC
CCCCCPCCCC
CCCNNHHHHH
HHHPCCCCCC

